　　eight - number between 7 and 9 八
　　ate - past tense of eat 吃的过去式


　　bear - a big, hairy animal 熊
　　bear - to be able to withstand something 忍受
　　bare - exposed 裸露的


　　bread - a type of food 面包
　　bred - past tense of breed 繁殖的过去式


　　break - to cause to separate into pieces suddenly 打破
　　brake - a device for slowing or stopping motion 闸


　　be - am, is, are  动词 be
　　bee - an insect  蜜蜂


　　caught - past tense of catch  抓的过去式
　　cot - a portable bed that folds for storage  轻便小床


　　fan - a device for moving air 风扇
　　fan - short for fanatic 狂热，爱好者


　　groan - noise made in misery 呻吟
　　grown - fully mature 长大的


　　hart- a male deer 雄鹿
　　heart - an organ of the body 心脏


　　herd - a group of animals 牧群
　　heard - past tense of hear  听的过去式


　　I - me, myself  我
　　eye - body part we see with 眼睛


　　made - past tense of make  做的过去式
　　maid - a lady that cleans home or hotels for a living 女佣


　　no - opposite of yes  不
　　know - be aware of something 知道


　　right - correct; opposite of "left" 对；右
　　write - to form letters or symbols 写


　　rose - a beautiful flower that grows on a thorny stem 玫瑰
　　roes - plural of roe 雌鹿的过去式
　　rows - plural of row 行，排
　　rows - present tense of row 划船的单数第三人称形式


　　wring - twist 绞，扭
　　ring - noise a bell makes 敲钟，打电话


　　scent - smell 气味
　　sent - past tense of send 邮寄的过去式


　　see - to view something 看见
　　sea - large body of salt water 海


　　threw - past tense of throw 扔的过去式
　　through - to give direction; finished or completed  穿过；完成


　　tail - cats and dogs have them  尾巴
　　tale - a story  故事


　　there 那边
　　their 他们的
　　they're 他们是


　　week - 7 days 周
　　weak - not strong 虚弱


　　worn - well used 用旧的，疲倦的；穿（wear）的过去分词
　　warn - to give notice of potential danger 警告


　　wood - what we get from trees 树木
　　would - past tense of will 将要，will的过去式


　　wore - past tense of wear  穿的过去式
　　war - what we call it when two countries' armies are fighting 战争


　　one - a single unit 一个
　　won - past tense of win 获胜的过去式        

                                           
　　you'll 你们将...
　　Yule - 圣诞季节

　　right - white
　　writing - riding
　　luck - lock
　　isn't - is an - is in
　　neater - neither
　　have to hear - have to be here
　　You bet - You'd better
　　…
